20 20
200 200 
7 7 7 7 7 7 7 7 7 7 7 7 7 7 7 7 7 7 7 7 
0 0 0 10 10 10 10 10 10 10 10 10 10 10 10 10 10 10 10 10 
10 10 10 10 10 10 10 10 10 26 27 28 10 10 10 10 10 10 10 10
10 10 10 10 10 10 10 10 10 29 30 31 10 10 10 10 10 10 10 10
1 1 1 1 1 1 1 1 1 1 1 1 1 1 1 1 1 1 1 1 
4 4 4 4 4 4 4 4 4 4 4 4 4 4 4 4 4 4 4 4 
4 4 4 4 4 4 4 4 4 4 4 4 4 4 4 4 4 4 4 4 
4 4 4 4 4 4 4 4 4 4 4 4 4 4 4 4 4 4 4 4 
19 4 4 4 4 4 4 4 4 4 4 4 4 4 4 4 4 4 4 4 
22 4 4 4 4 4 4 4 4 4 4 4 4 4 4 4 4 4 4 4 
22 4 4 4 4 4 4 4 4 4 4 4 4 4 4 4 4 4 4 4 
22 4 4 4 4 4 4 4 4 4 4 4 4 4 4 4 4 4 4 4 
22 4 4 4 4 4 4 4 4 4 4 4 4 4 4 4 4 4 4 4 
25 4 4 4 4 4 4 4 17 18 19 4 4 4 4 4 4 4 4 4 
4 4 4 4 4 4 4 4 20 21 22 4 4 4 4 4 4 4 4 4 
4 4 4 4 4 4 4 4 23 24 25 4 4 4 4 4 4 4 4 4  
4 4 4 4 4 4 4 4 4 4 4 4 4 4 4 4 4 4 4 4 
4 4 4 4 4 4 4 4 4 4 4 4 4 4 4 4 4 4 4 4 
4 4 4 4 4 4 4 4 4 4 4 4 4 4 4 4 4 4 4 4 
4 4 4 4 4 4 4 4 4 4 4 4 4 4 4 4 4 4 4 4 
10/3 